110,110,110,110,110,110,110,110,110,110,110,110,110,110,110,110,110,110,110,110,110,110,110,110,110,110,110,110,110,110,110,110,110,110,110,110,110,110,110,110,110,110,110,110,110,110,110,110,110,110,110,110,110,110,110,110,110,110,110,110,110,110,110,110
110,110,110,110,110,110,110,110,110,110,110,110,110,110,110,110,110,110,110,110,110,110,110,110,110,110,110,110,110,110,110,110,110,110,110,110,110,110,110,110,110,110,110,110,110,110,110,110,110,110,110,110,110,110,110,110,110,110,110,110,110,110,110,110
110,110,110,110,110,110,110,110,110,110,110,110,110,110,110,110,110,110,110,110,110,110,110,110,110,110,110,110,110,110,110,110,110,110,110,110,110,110,110,110,110,110,110,110,110,110,110,110,110,110,110,110,110,110,110,110,110,110,110,110,110,110,110,110
110,110,110,110,110,110,110,110,110,110,110,110,110,110,110,110,110,110,110,110,110,110,110,110,110,110,110,110,110,110,110,110,110,110,110,110,110,110,110,110,110,110,110,110,110,110,110,110,110,110,110,110,110,110,110,110,110,110,110,110,110,110,110,110
110,110,110,110,110,110,110,110,110,110,110,110,110,110,110,110,110,110,1,2,110,110,110,110,110,110,110,110,110,110,110,110,110,110,110,110,110,110,110,110,110,110,110,110,110,110,110,110,110,110,110,110,110,110,110,110,110,110,110,110,110,110,110,110
110,110,110,110,110,110,110,110,110,110,110,110,110,110,110,110,110,0,23,24,110,110,110,110,110,110,110,110,110,110,110,110,110,110,110,110,110,110,110,110,110,110,110,110,110,110,110,110,110,110,110,110,110,110,110,110,110,110,110,110,110,110,110,110
110,110,110,110,110,110,110,110,110,110,110,110,110,110,110,110,110,22,89,24,110,110,110,110,110,110,110,110,110,110,110,110,110,110,110,110,110,110,110,110,110,110,110,110,110,110,110,110,110,110,110,110,110,110,110,110,110,110,110,110,110,110,110,110
110,110,110,110,110,110,110,110,110,110,110,110,110,110,110,110,110,22,110,110,110,110,110,110,110,110,110,110,110,110,110,110,110,110,110,110,110,110,110,110,110,110,110,110,110,110,110,110,110,110,110,110,110,110,110,110,110,110,110,110,110,110,110,110
110,110,110,110,110,110,110,110,110,110,110,110,110,110,110,110,110,110,110,110,110,110,110,110,110,110,110,110,110,110,110,110,110,110,110,110,110,110,110,110,110,110,110,110,110,110,110,110,110,110,110,110,110,110,110,110,110,110,110,110,110,110,110,110
110,110,110,110,110,110,110,110,110,110,110,110,110,110,110,110,110,110,110,110,110,110,110,110,110,110,110,110,110,110,110,110,110,110,110,110,110,110,110,110,110,110,110,110,110,110,110,110,110,110,110,110,22,23,24,110,110,110,110,110,110,110,110,110
110,110,110,110,110,110,110,110,110,110,110,110,110,110,110,110,110,110,110,110,110,110,110,110,110,110,0,1,1,1,1,1,2,110,110,110,110,110,110,110,110,110,110,110,110,110,110,110,110,110,110,110,44,45,46,110,110,110,110,110,110,110,110,110
110,110,110,110,110,110,110,110,110,110,110,110,110,110,110,110,110,110,110,110,110,110,110,110,0,1,50,23,89,23,23,23,49,1,1,1,1,1,1,2,110,110,110,110,110,110,110,110,110,110,110,110,110,110,110,110,110,110,110,110,110,110,110,110
110,110,110,110,110,110,0,110,2,110,110,110,110,110,110,110,110,110,110,110,110,110,110,110,22,23,23,23,23,23,23,23,23,23,23,23,89,23,23,24,110,110,110,110,110,110,110,110,110,110,110,110,110,110,110,110,110,110,110,110,110,110,110,110
110,110,110,110,110,110,22,110,24,110,110,110,110,110,110,110,110,110,110,110,110,110,110,110,22,89,23,23,88,88,23,23,88,23,23,23,23,23,23,24,110,110,110,110,110,110,110,110,110,110,110,110,110,110,110,110,110,110,110,110,110,110,110,110
110,110,110,110,110,110,44,110,46,110,110,110,110,110,110,110,110,110,110,110,110,110,110,110,22,23,23,23,88,23,23,89,23,23,23,23,23,23,23,24,110,110,110,0,1,1,2,110,110,110,110,110,110,110,110,110,110,110,110,110,110,110,110,110
110,110,110,110,110,110,110,110,110,110,110,110,110,110,110,110,110,110,110,110,110,110,110,110,22,23,23,23,23,23,88,23,23,23,23,88,88,23,89,24,110,110,110,22,88,23,24,110,110,110,110,110,110,110,110,110,110,110,110,110,110,110,110,110
110,110,110,110,110,110,110,110,110,110,110,110,110,110,110,110,110,110,110,110,110,110,110,110,22,88,89,23,23,23,23,23,23,23,23,88,23,23,27,46,110,110,110,22,23,89,24,110,110,110,110,110,110,110,110,110,110,110,110,110,110,110,110,110
110,110,110,110,110,110,110,110,110,110,110,110,110,110,110,110,110,110,110,110,110,110,110,110,44,28,23,88,88,23,23,23,23,89,23,23,23,27,46,111,110,110,110,44,45,45,46,110,110,110,110,110,110,110,110,110,110,110,110,110,110,110,110,110
110,110,110,110,110,110,110,110,110,110,110,110,110,110,110,0,1,1,110,110,110,110,110,110,110,22,23,23,23,23,23,23,23,23,27,45,45,46,111,111,110,110,110,110,110,110,110,110,110,110,110,110,110,110,110,110,110,110,110,110,110,110,110,110
110,110,110,110,110,110,110,110,110,110,110,110,110,110,110,22,88,23,110,110,110,110,110,110,110,44,45,45,45,28,23,23,23,23,24,110,110,110,110,110,110,110,110,110,110,110,110,110,110,110,110,110,110,110,110,110,110,110,110,110,110,110,110,110
110,110,110,110,110,110,110,110,110,110,110,110,110,110,110,22,23,89,110,110,110,110,110,110,110,110,110,110,110,22,23,23,23,23,24,110,110,110,110,110,110,110,110,110,110,110,110,110,110,110,110,110,110,110,110,110,110,110,110,110,110,110,110,110
110,110,110,110,110,110,110,110,110,110,110,110,110,110,110,44,45,45,110,110,110,110,110,110,110,110,110,110,110,22,23,23,23,23,24,110,110,110,110,110,110,110,110,110,110,110,110,110,110,110,110,110,110,110,110,110,110,110,110,110,110,110,110,110
110,110,110,110,110,110,110,110,110,110,110,110,110,110,110,110,110,110,110,110,110,110,110,110,110,110,110,110,110,22,23,23,23,23,24,110,110,110,110,110,110,110,110,110,110,110,110,110,110,110,110,110,110,110,110,110,110,110,110,110,110,110,110,110
110,110,110,110,110,110,110,110,110,110,110,110,110,110,110,110,110,110,110,110,110,110,110,110,110,110,110,110,110,22,23,23,23,23,24,110,110,110,110,110,0,1,1,1,1,2,110,110,110,110,110,110,110,110,110,110,110,110,110,110,110,110,110,110
110,110,110,110,110,110,110,110,110,110,110,110,110,110,110,110,110,110,110,110,110,110,110,110,110,110,110,110,110,22,23,23,23,23,24,110,110,110,110,110,22,23,23,23,23,24,110,110,110,110,110,110,110,110,110,110,110,110,110,110,110,110,110,110
110,110,110,110,110,110,110,110,110,110,110,110,110,110,110,110,110,110,110,0,1,1,1,1,1,1,1,1,1,22,23,23,23,23,24,1,1,1,1,1,50,23,23,23,23,24,110,110,110,110,110,110,110,110,110,110,110,110,110,110,110,110,110,110
110,110,110,110,110,110,110,110,110,110,110,110,110,110,110,110,110,110,110,22,23,23,23,23,23,23,23,23,23,286,287,287,287,287,288,23,23,23,23,23,23,23,23,23,23,24,110,110,110,110,110,110,110,110,110,110,110,110,110,110,110,110,110,110
110,110,110,110,110,110,110,110,110,110,110,110,110,110,110,110,110,110,0,50,23,11,12,12,12,12,12,12,12,308,309,309,309,309,310,12,12,12,12,12,12,12,13,23,27,46,110,110,110,110,110,110,110,110,110,110,110,110,110,110,110,110,110,110
110,110,110,110,110,110,110,110,110,110,110,110,110,110,110,110,110,110,22,23,23,33,270,274,274,274,274,274,274,308,309,309,309,309,310,274,271,274,274,271,274,274,35,23,24,110,110,110,110,110,110,110,110,110,110,110,0,1,1,2,110,110,110,110
110,110,110,110,110,110,110,110,110,110,110,110,110,110,110,110,110,110,22,23,23,33,274,272,274,252,274,274,274,308,309,309,309,309,310,274,274,252,274,274,272,274,35,23,24,110,110,110,110,110,110,110,110,110,110,110,22,88,23,24,110,110,110,110
110,110,110,110,110,110,110,110,110,110,110,110,110,110,110,110,110,110,22,23,23,33,274,271,274,274,274,274,274,308,309,309,309,309,310,274,274,274,274,274,274,274,35,23,24,110,110,110,110,110,110,110,110,110,110,110,22,23,89,24,110,110,110,110
110,110,110,110,110,110,110,110,110,110,110,110,110,110,110,110,110,110,44,28,23,33,272,274,270,274,272,274,274,308,309,309,309,309,310,274,274,273,274,270,274,271,35,23,24,110,110,110,110,110,110,110,110,110,110,110,44,45,45,46,110,110,110,110
110,110,110,110,110,110,110,110,110,110,110,110,110,110,110,110,110,110,110,22,23,33,274,274,274,271,274,274,274,308,309,309,309,309,310,274,274,274,274,274,274,274,35,23,24,110,110,110,110,110,110,110,110,110,110,110,110,110,110,110,110,110,110,110
110,110,110,110,110,110,110,110,110,110,110,110,110,110,110,110,110,110,110,22,23,33,274,252,274,274,274,274,274,308,309,309,309,309,310,270,274,272,274,252,274,274,35,23,24,110,110,110,110,110,110,110,110,110,110,110,110,110,110,110,110,110,110,110
110,110,110,110,0,1,2,110,110,110,110,110,110,110,110,110,110,110,110,22,23,33,271,274,274,274,273,274,271,308,309,309,309,309,310,274,274,274,274,274,270,272,35,23,24,110,110,110,110,110,110,110,110,110,110,110,110,110,110,110,110,110,110,110
110,110,110,110,22,23,24,110,110,110,110,110,110,110,110,110,110,110,110,22,23,55,56,56,56,56,56,56,56,308,309,309,309,309,310,56,56,56,56,56,56,56,57,23,24,110,110,110,110,110,110,110,110,110,110,110,110,110,110,110,110,110,110,110
110,110,110,110,44,45,46,110,110,110,110,110,110,110,110,110,110,110,110,22,23,23,23,23,23,23,23,23,23,308,309,309,309,309,310,23,23,23,23,23,23,23,23,23,24,110,110,110,110,110,110,110,110,110,110,110,110,110,110,110,110,110,110,110
110,110,110,110,110,110,110,110,110,110,110,110,110,110,110,110,110,110,110,44,45,45,45,45,45,45,45,45,45,28,23,23,23,23,27,45,45,28,23,23,23,23,23,27,46,110,110,110,110,110,110,110,110,110,110,110,110,110,110,110,110,110,110,110
110,110,110,110,110,110,110,110,110,110,110,110,110,110,110,110,110,110,110,110,110,110,110,110,110,110,110,110,110,22,23,23,23,23,24,110,110,22,23,23,23,23,23,24,110,110,110,110,110,110,0,1,1,2,110,110,110,110,110,110,110,110,110,110
110,110,110,110,110,110,110,110,110,110,110,110,110,110,110,110,110,110,110,110,110,110,110,110,110,110,110,110,110,22,23,23,23,23,24,110,110,44,45,45,45,45,45,46,110,110,110,110,110,110,22,88,23,24,110,110,110,0,1,2,110,110,110,110
110,110,110,110,110,110,110,110,110,110,110,110,110,110,110,110,110,110,110,110,110,110,110,110,110,110,110,110,110,22,23,23,23,23,24,110,110,110,110,110,110,110,110,110,110,110,110,110,110,110,22,23,89,24,110,110,110,22,23,24,110,110,110,110
110,110,110,110,110,110,110,110,110,110,110,110,110,110,110,110,110,110,110,110,110,110,110,110,110,110,110,110,110,22,23,23,23,23,24,110,110,110,110,110,110,110,110,110,110,110,110,110,110,110,44,45,45,46,110,110,110,44,45,46,110,110,110,110
110,110,110,110,110,110,110,110,110,110,110,110,0,1,1,2,110,110,110,110,110,110,110,110,110,110,110,110,110,22,23,23,23,23,24,110,110,110,110,110,110,110,110,110,110,110,110,110,110,110,110,110,110,110,110,110,110,110,110,110,110,110,110,110
110,110,110,110,110,110,110,110,110,110,110,110,22,88,23,24,110,110,110,110,110,110,110,110,110,110,110,110,110,22,23,23,23,23,24,110,110,110,110,110,110,110,110,110,110,110,110,110,110,110,110,110,110,110,110,110,110,110,110,110,110,110,110,110
110,110,110,110,110,110,110,110,110,110,110,110,22,23,89,24,110,110,110,110,110,110,110,110,110,110,110,110,110,22,23,23,23,23,24,110,110,110,110,110,110,110,110,110,110,110,110,110,110,110,110,110,110,110,110,110,110,110,110,110,110,110,110,110
110,110,110,110,110,110,110,110,110,110,110,110,44,45,45,46,110,110,110,110,110,110,110,110,110,110,110,110,110,22,23,23,23,23,24,110,110,110,110,110,110,110,110,110,110,110,110,110,110,110,110,110,110,110,110,110,110,110,110,110,110,110,110,110
110,110,110,110,110,110,110,110,110,110,110,110,110,110,110,110,110,110,110,110,110,110,110,110,110,110,110,110,110,22,23,23,23,23,24,110,110,110,110,110,110,0,1,2,110,110,110,110,110,110,110,110,110,110,110,110,110,110,110,110,110,110,110,110
110,110,110,110,110,110,110,110,110,110,110,110,110,110,110,110,110,110,110,110,110,110,110,110,110,110,110,0,1,50,23,23,23,23,49,1,2,110,110,110,110,22,23,24,110,110,110,110,110,110,110,110,110,110,110,110,110,110,110,110,110,110,110,110
110,110,110,110,110,110,110,110,110,110,110,110,110,110,110,110,110,110,110,110,110,110,110,110,110,110,110,22,23,88,23,23,23,23,23,89,24,110,110,110,110,44,45,46,110,110,110,110,110,110,110,110,110,110,110,110,110,0,1,1,2,110,110,110
110,110,110,110,110,110,110,110,110,110,110,110,110,110,110,110,110,110,110,110,110,110,110,110,110,110,110,22,89,23,23,23,23,88,23,23,24,110,110,110,110,110,110,110,110,110,110,110,110,110,110,110,110,110,110,110,110,22,88,23,24,110,110,110
110,110,110,110,110,110,110,110,110,110,110,110,110,110,110,110,110,110,110,110,110,110,110,110,110,110,110,22,23,23,23,23,23,23,23,23,24,110,110,110,110,110,110,110,110,110,110,110,110,110,110,110,110,110,110,110,110,22,23,89,24,110,110,110
110,110,110,110,110,110,110,110,110,110,110,110,110,110,110,110,110,110,110,110,110,110,110,110,110,110,110,22,23,89,23,88,23,89,23,23,24,110,110,110,110,110,110,110,110,110,110,110,110,110,110,110,110,110,110,110,110,44,45,45,46,110,110,110
110,110,110,110,110,110,110,110,110,110,110,110,110,110,110,110,110,110,110,110,110,110,110,0,1,2,110,22,88,23,23,23,23,23,23,88,24,110,110,110,110,110,110,110,110,110,110,110,110,110,110,110,110,110,110,110,110,110,110,110,110,110,110,110
110,110,110,110,110,110,110,110,110,110,110,0,1,2,110,110,110,110,110,110,110,110,110,22,23,24,110,22,23,89,23,23,23,88,89,23,24,110,110,110,110,110,110,110,110,110,110,110,110,110,110,110,110,110,110,110,110,110,110,110,110,110,110,110
110,110,110,110,110,110,110,110,110,110,110,22,23,24,110,110,110,110,110,110,110,110,110,44,45,46,110,44,45,45,45,45,45,45,45,45,46,110,110,110,110,110,110,110,110,110,110,110,110,110,110,110,110,110,110,110,110,110,110,110,110,110,110,110
110,110,110,110,110,110,110,110,110,110,110,44,45,46,110,110,110,110,110,110,110,110,110,110,110,110,110,110,110,110,110,110,110,110,110,110,110,110,110,110,110,110,110,110,110,110,110,110,110,110,110,110,110,110,110,110,110,110,110,110,110,110,110,110
110,110,110,110,110,110,110,110,110,110,110,110,110,110,110,110,110,110,110,110,110,110,110,110,110,110,110,110,110,110,110,110,110,110,110,110,110,110,110,110,110,110,110,110,0,1,1,110,110,110,110,110,110,110,110,110,110,110,110,110,110,110,110,110
110,110,110,0,1,1,2,110,110,110,110,110,110,110,110,110,110,110,1,2,110,110,110,110,110,110,110,110,110,110,110,110,110,110,110,110,110,110,110,110,110,110,110,110,22,88,23,110,2,110,110,110,110,110,110,110,110,110,110,110,110,110,110,110
110,110,110,22,88,23,24,110,110,110,110,110,110,110,110,110,110,0,1,110,110,110,110,110,110,110,110,110,110,110,110,110,110,110,110,110,110,110,110,110,110,110,110,110,110,110,110,110,24,110,110,110,110,110,110,0,1,2,110,110,110,110,110,110
110,110,110,22,23,89,24,110,110,110,110,110,110,110,110,110,110,22,88,23,24,110,110,110,110,110,110,110,110,110,110,110,110,110,110,110,110,110,110,110,110,110,110,110,110,22,23,89,24,110,110,110,110,110,110,22,23,24,110,110,110,110,110,110
110,110,110,44,45,45,46,110,110,110,110,110,110,110,110,110,110,22,23,89,24,110,110,110,110,110,110,110,110,110,110,110,110,110,110,110,110,110,110,110,110,110,110,110,110,44,45,45,46,110,110,110,110,110,110,44,45,46,110,110,110,110,110,110
110,110,110,110,110,110,110,110,110,110,110,110,110,110,110,110,110,44,45,45,46,110,110,110,110,110,110,110,110,110,110,110,110,110,110,110,110,110,110,110,110,110,110,110,110,110,110,110,110,110,110,110,110,110,110,110,110,110,110,110,110,110,110,110
110,110,110,110,110,110,110,110,110,110,110,110,110,110,110,110,110,110,110,110,110,110,110,110,110,110,110,110,110,110,110,110,110,110,110,110,110,110,110,110,110,110,110,110,110,110,110,110,110,110,110,110,110,110,110,110,110,110,110,110,110,110,110,110
110,110,110,110,110,110,110,110,110,110,110,110,110,110,110,110,110,110,110,110,110,110,110,110,110,110,110,110,110,110,110,110,110,110,110,110,110,110,110,110,110,110,110,110,110,110,110,110,110,110,110,110,110,110,110,110,110,110,110,110,110,110,110,110
